"a" = (/obj/effect/turf_decal/trimline/brown/end{dir = 4},/turf/open/floor/iron/white/textured_large,/area/space)
"h" = (/obj/effect/turf_decal/trimline/brown/end,/turf/open/floor/iron/white/textured_large,/area/space)
"m" = (/obj/effect/turf_decal/trimline/dark/filled/corner{dir = 4},/obj/effect/turf_decal/trimline/brown,/turf/open/floor/iron/white/textured_large,/area/space)
"n" = (/obj/effect/turf_decal/trimline/brown/filled/end{dir = 1},/turf/open/floor/iron/white/textured_large,/area/space)
"q" = (/obj/effect/turf_decal/trimline/brown/filled/line{dir = 5},/turf/open/floor/iron/white/smooth_large,/area/space)
"t" = (/obj/effect/turf_decal/trimline/dark/filled/corner{dir = 1},/obj/effect/turf_decal/trimline/brown,/turf/open/floor/iron/white/textured_large,/area/space)
"u" = (/obj/effect/turf_decal/trimline/brown/end{dir = 8},/turf/open/floor/iron/white/smooth_large,/area/space)
"y" = (/obj/effect/turf_decal/trimline/brown/corner{dir = 8},/turf/open/floor/iron/white/textured_large,/area/space)
"A" = (/obj/effect/turf_decal/trimline/brown/end{dir = 4},/turf/open/floor/iron/white/smooth_large,/area/space)
"G" = (/obj/effect/turf_decal/trimline/brown/corner,/obj/effect/turf_decal/trimline/brown/line{dir = 9},/turf/open/floor/iron/white/smooth_large,/area/space)
"H" = (/obj/effect/turf_decal/trimline/dark/filled/corner{dir = 4},/obj/effect/turf_decal/trimline/dark/filled/corner{dir = 1},/obj/effect/turf_decal/trimline/brown/filled/line,/turf/open/floor/iron/white/smooth_large,/area/space)
"I" = (/obj/effect/turf_decal/trimline/dark/filled/corner{dir = 8},/obj/effect/turf_decal/trimline/brown/line{dir = 5},/turf/open/floor/iron/white/smooth_large,/area/space)
"L" = (/turf/open/floor/iron/white/textured_large,/area/space)
"N" = (/obj/effect/turf_decal/trimline/brown/corner,/turf/open/floor/iron/white/textured_large,/area/space)
"P" = (/turf/open/floor/iron/white/smooth_large,/area/space)
"R" = (/obj/effect/turf_decal/trimline/dark/filled/corner{dir = 8},/obj/effect/turf_decal/trimline/brown/corner,/turf/open/floor/iron/white/textured_large,/area/space)
"Z" = (/obj/effect/turf_decal/trimline/brown/filled/line{dir = 9},/turf/open/floor/iron/white/smooth_large,/area/space)

(1,1,1) = {"
PNPyP
LGRIh
AmHtu
aZnqL
PLPLP
"}
