"a" = (/obj/effect/turf_decal/tile/brown/half,/turf/open/floor/iron/white/textured_large,/area/space)
"c" = (/turf/open/floor/iron/white/smooth_large,/area/space)
"d" = (/obj/effect/turf_decal/trimline/darkblue/line{dir = 4},/obj/effect/turf_decal/trimline/darkblue/line{dir = 8},/turf/open/floor/iron/white/smooth_large,/area/space)
"f" = (/obj/effect/turf_decal/trimline/green/line{dir = 8},/obj/effect/turf_decal/trimline/green/line{dir = 4},/turf/open/floor/iron/white/textured_large,/area/space)
"h" = (/obj/effect/turf_decal/trimline/green/end,/obj/effect/turf_decal/trimline/green/filled/end,/obj/effect/turf_decal/box/blue/corners{color = "#9FED58"},/turf/open/floor/iron/white/smooth_large,/area/space)
"i" = (/turf/open/floor/iron/white/textured_large,/area/space)
"s" = (/obj/effect/turf_decal/tile/brown/half,/turf/open/floor/iron/white/smooth_large,/area/space)
"D" = (/obj/effect/turf_decal/trimline/white/line{dir = 8},/obj/effect/turf_decal/trimline/white/line{dir = 4},/turf/open/floor/iron/white/smooth_large,/area/space)
"H" = (/obj/effect/turf_decal/trimline/darkblue/line{dir = 8},/obj/effect/turf_decal/trimline/darkblue/line{dir = 4},/turf/open/floor/iron/white/textured_large,/area/space)
"T" = (/obj/effect/turf_decal/trimline/darkblue/end,/obj/effect/turf_decal/trimline/darkblue/filled/end,/obj/effect/turf_decal/box/blue/corners,/turf/open/floor/iron/white/smooth_large,/area/space)
"Y" = (/obj/effect/turf_decal/trimline/white/end,/obj/effect/turf_decal/trimline/white/filled/end,/obj/effect/turf_decal/box/white/corners,/turf/open/floor/iron/white/textured_large,/area/space)

(1,1,1) = {"
cacic
idisi
cHDfc
iTYhi
cicic
"}
