"a" = (/obj/effect/turf_decal/trimline/purple,/obj/effect/turf_decal/trimline/blue/filled/line{dir = 6},/turf/open/floor/iron/white/smooth_large,/area/medical/medbay/factory)
"e" = (/turf/open/floor/iron/white/smooth_large,/area/medical/medbay/factory)
"s" = (/obj/effect/turf_decal/trimline/purple,/obj/effect/turf_decal/trimline/blue/filled/line{dir = 10},/turf/open/floor/iron/white/smooth_large,/area/medical/medbay/factory)
"v" = (/obj/effect/turf_decal/trimline/dark/filled/corner{dir = 4},/obj/effect/turf_decal/trimline/blue/filled/corner{pixel_y = 0; dir = 8},/turf/open/floor/iron/white/textured_large,/area/medical/medbay/factory)
"w" = (/obj/effect/turf_decal/trimline/dark/filled/corner{dir = 4},/obj/effect/turf_decal/trimline/blue/filled/corner{pixel_y = 0; dir = 1},/turf/open/floor/iron/white/smooth_large,/area/medical/medbay/factory)
"z" = (/obj/effect/turf_decal/trimline/blue/end{dir = 4},/turf/open/floor/iron/white/textured_large,/area/medical/medbay/factory)
"C" = (/obj/effect/turf_decal/trimline/blue/filled/line{dir = 6},/obj/effect/turf_decal/trimline/blue/corner{dir = 1},/turf/open/floor/iron/white/smooth_large,/area/medical/medbay/factory)
"K" = (/obj/effect/turf_decal/trimline/blue/end{dir = 8},/turf/open/floor/iron/white/smooth_large,/area/medical/medbay/factory)
"L" = (/obj/effect/turf_decal/trimline/blue/filled/line{dir = 10},/obj/effect/turf_decal/trimline/blue/corner{dir = 4},/turf/open/floor/iron/white/smooth_large,/area/medical/medbay/factory)
"O" = (/obj/effect/turf_decal/trimline/blue/end{pixel_y = 0; dir = 4},/turf/open/floor/iron/white/smooth_large,/area/medical/medbay/factory)
"P" = (/obj/effect/turf_decal/trimline/blue/filled/corner{pixel_y = 0; dir = 1},/obj/effect/turf_decal/trimline/blue/filled/corner{pixel_y = 0},/turf/open/floor/iron/white/textured_large,/area/medical/medbay/factory)
"R" = (/obj/effect/turf_decal/trimline/blue/end{dir = 8},/turf/open/floor/iron/white/textured_large,/area/medical/medbay/factory)
"S" = (/turf/open/floor/iron/white/textured_large,/area/medical/medbay/factory)
"V" = (/obj/effect/turf_decal/trimline/blue/corner{dir = 4},/obj/effect/turf_decal/trimline/blue/corner{dir = 1},/turf/open/floor/iron/white/textured_large,/area/medical/medbay/factory)

(1,1,1) = {"
eSeSe
SsSaS
OvwPK
zLVCR
eSeSe
"}
